11111111111
1E01CC1C001
1PC0000C011
1C000011111
11111111111