11111111111111111111111
10000000000000000000001
10000000000000P00000001
10000000000000000000001
100000000C0000000000001
10000000000000000000001
10E00000000C00000000001
11111111111111111111111