11111111111111111111111111111111111111111111111111111111111111111111111111111111111111111111111111111111111111111111111111
10000000000000000000001111111111111111111111111111111111111111111111111111111111111111111111111111111111111111111111111111
10000000000000P00000001111111111111111111111111111111111111111111111111111111111111111111111111111111111111111111111111111
10000000000000000000001111111111111111111111111111111111111111111111111111111111111111111111111111111111111111111111111111
111000001C1000000000001111111111111111111111111111111111111111111111111111111111111111111111111111111111111111111111111111
10100E00010000000000001111111111111111111111111111111111111111111111111111111111111111111111111111111111111111111111111111
1011C000000C00000000001111111111111111111111111111111111111111111111111111111111111111111111111111111111111111111111111111
11111111111111111111111111111111111111111111111111111111111111111111111111111111111111111111111111111111111111111111111111