11111111111111111111111
10000C0000000C000000001
10000010001000P00000001
1000000000000C000010001
100001100C0000000000001
10100C00000000001000001
1010000000C000010000011
10000000000000000000001
10000C0000000C000000001
10000010001000100010001
1000000000000C000000001
100001100C0000000000001
10100C00000000001000001
10E10000000C00001000001
11111111111111111111111